

NO ./path_to_the_north_texture.xpm
SO ./path_to_the_south_texture.xpm
WE ./path_to_the_west_texture.xpm
EA ./path_to_the_east_texture.xpm



F 220,9,0
C 255,10,0
000000110000
111111N11111  11111
111111111111

11111