

NO ./path_to_the_north_texture.xpm
SO ./path_to_the_south_texture.xpm
WE ./path_to_the_west_texture.xpm
EA ./path_to_the_east_texture.xpm



F 220,100,0
C 255,30,0


1111   1111
11011  11111
1101   111
1N01   1001
111111111
11111111