

NO ./textures/Icon16.xpm 
SO ./textures/BrickFireRed.xpm

WE ./textures/Icon10.xpm
EA ./textures/epic.xpm

F 15,230,90
C 135,5,235

111111111111111111111111111
111111111111111111111111111
111111111111111111111111111
111111111111111111111111111
100000000000N00000000000001
100000000000000000000000001
100000000000000000000000001
100000000000000000000000001
111111111111111111111111111
100000000000000000000000001    
100000000000000000000000001   
100000000000000000000000001    
100000000000000000000000001
111111111111111111111111111
