

                NO ./path_to_the_north_texture.xpm
                  SO ./path_to_the_south_texture.xp


 EA ./path_to_the_east_texture.xpm
 WE ./path_to_the_west_texture.xpm
 F 0,100,0
 C 255,250,250



1111
1N01
1111